R 1280 800
NO textures/redbrick.xpm
SO textures/wood.xpm
WE textures/eagle.xpm
EA textures/purplestone.xpm
S textures/guard.xpm
F 184,113,39
C 51,198,227

1111111111
1000000021
1000000001
1002000N01
1000000001
1000000001
1000000001
1000001001
1001000001
1111111111
