R 123456789 234567890
NO textures/redbrick.xpm
EA textures/purplestone.xpm
SO textures/wood.xpm
WE textures/eagle.xpm
S textures/guard.xpm
F 184,113,39
C 51,198,227

11111111111111111111
10000002020000010001
10200000000000010001
10000000000000000001
10001101010101000001
10000001000000000001
10000001000000000021
10020000000000000021
10000000002000000001
10010010000000000001
10010000000000N00001
10020020000000000001
11111111111111111111
